NAME: AI Test 3
LENGTH: 9
HEIGHT: 9
KEYS: 0

MAP:
*********
*D200000*
*2222301*
*****101*
*****101*
*1111101*
*10C0001*
*1111111*
*********