NAME: AI Test 2
LENGTH: 9
HEIGHT: 11
KEYS: 0

MAP:
*********
*D000000*
*2222200*
*****100*
*000*1C0*
*000*100*
*000*100*
*000*100*
*0001200*
*0000000*
*********