NAME: AI Test 1
LENGTH: 9
HEIGHT: 9
KEYS: 0

MAP:
*********
*D000000*
*0000000*
*0000000*
*00000C0*
*0000000*
*0000000*
*0000000*
*********
