NAME: Gate Test 1
LENGTH: 9
HEIGHT: 9
KEYS: 2

MAP:
*********
*0000000*
*00K0000*
*0000000*
*00000C0*
*0K00000*
*0000000*
*0000000*
***XX****
