NAME: Motion Test 2
LENGTH: 9
HEIGHT: 9
KEYS: 0

MAP:
*********
*0000000*
*1111000*
*****100*
*000*1C0*
*000*100*
*000*100*
*0000000*
*********