NAME: Testing Level
LENGTH: 9
HEIGHT: 9
KEYS: 1

MAP:
*********
*111111D*
*1000001*
*1T0C001*
*1T00000*
*1TK0001*
*1000001*
*1111111*
***XX****